NO ./pics/nam.xpm
EA ./pics/seo.xpm
SO ./pics/book.xpm
WE ./pics/dong.xpm

F 0,0,0
C 111,111,222


        1111111111111111111111111
        1000000000110000000000001
        1011000001110000000000001
        1001000000000000000000001
        1000000000110111111000001
        1011000001110888888E00001
        1001000000000111111000001
111111111011000001110000000000001
100000000011000000110111111111111
11110111111111111100000010001
11110111111111111101010010001
11000000110101111100000010001
10000000000000001100000010001
10000000000000001101010010001
1100000111010101111101111000111
11110111 1110101 10111  10001
11111111 1111111 111111111111


