NO ./pics/bluestone.xpm
EA ./pics/colorstone.xpm
SO ./pics/greystone.xpm
WE ./pics/redbrick.xpm

F 000,000,000
C 255,255,255

11111111111
10100000001
10100000001
10100011811
10000000001
10000E00001
10000000001
10000000001
10000000001
10000000001
11111111111

