NO ./pics/bluestone.xpm
EA ./pics/colorstone.xpm
SO ./pics/greystone.xpm
WE ./pics/redbrick.xpm

F 000,000,000
C 255,255,255

1111111111111111111111111111111111111
11111111N1111111111111111111111111111
1000000000000000000000000000000000001
1111111121111111111111111111111111101
1000000000000010000000010000000000101
1011101111111010111011110111111110101
1000000100000010101000000100000000101
1010111111111110100010111101101110101
1010000100010000101110100001000000101
1011111001010111110000101101011111101
1000000010000100000111100000000000101
1111111110111101111100010111110110101
1000000010000000010001000000000100101
1010110111111111010110110101010001101
1010010011000000010000010000110111101
1111110001011111010111011110000000101
1000000101010000000101101010111110101
1010111000100111111100000000010000101
1110101111010000001011111110110110101
1110101111010111101011111110110110101
1000100010011000100010001000100000101
1010001000100010001000100010001111101
1111111111181111111111111111111111101
1000000000000000000000000000000000001
1111111111111111111111111111111111111